#######################
#   O    X            #
# O             X    O#
####          #########
#            P       O#
#  XX             X   #
#        O            #
#######################
