#######
#    P#
#  X  #
#    O#
#######
